________________________________________________
________________________________________________
________________________________________________
________________________________________________
________________________________________________
________________________________________________
________________________________________________
________________________________________________
________________________________________________
________________________________________________
_______________##################_______________
_______________#...____&_____...#_______________
_______________#.##_###0####_##.#_______________
################.##_###_####_##.################
________________*___###$####___*________________
################.##_###&####_##.################
_______________#.##_########_##.#_______________
_______________#.##__________##.#_______________
_______________#.##_########_##.#_______________
_______________#.......@........#_______________
_______________##################_______________
________________________________________________
________________________________________________
________________________________________________
________________________________________________
________________________________________________
________________________________________________
________________________________________________
________________________________________________
________________________________________________
________________________________________________
________________________________________________