________________________________________________
________________________________________________
________________________________________________
________________________________________________
________________________________________________
________________________________________________
________________________________________________
________________________________________________
________________________________________________
________________________________________________
################################################
1_______________................________________
################.######__######.################
################.######__######.################
0_______________*......&&......*________________
################.######$$######.################
0_______________*#&__________&#*________________
################.#____________#.################
################.##############.################
2_______________.......@........________________
################################################
________________________________________________
________________________________________________
________________________________________________
________________________________________________
________________________________________________
________________________________________________
________________________________________________
________________________________________________
________________________________________________
________________________________________________
________________________________________________