________________________________________________
________________________________________________
________________________________________________
________________________________________________
________________________________________________
________________________________________________
________________________________________________
________________________________________________
_____________________######_____________________
_____________________#&##&#_____________________
######################$##$######################
1_______________................________________
################.##############.################
################.##############.################
0_______________*......&&......*________________
################.##############.################
################.##############.################
2_______________.......@........________________
################################################
________________________________________________
________________________________________________
________________________________________________
________________________________________________
________________________________________________
________________________________________________
________________________________________________
________________________________________________
________________________________________________
________________________________________________
________________________________________________
________________________________________________
________________________________________________
