________________________________________________
________________________________________________
________________________________________________
________________________________________________
________________________________________________
________________________________________________
________________________________________________
________________________________________________
________________________________________________
________________________________________________
_______________##################_______________
_____________###.##.............#_______________
_____________#%$.##.###0####.##.#_______________
################.##.###&####.##.################
________________*...________...*________________
################.##.########.##.################
_______________#.##.########.##.#_______________
_______________#.......@.....##.#_______________
_______________##################_______________
________________________________________________
________________________________________________
________________________________________________
________________________________________________
________________________________________________
________________________________________________
________________________________________________
________________________________________________
________________________________________________
________________________________________________
________________________________________________
________________________________________________
________________________________________________
