________________________________________________
________________________________________________
________________________________________________
________________________________________________
________________________________________________
________________________________________________
________________________________________________
________________________________________________
_____________________######_____________________
_____________________#&##&#_____________________
_______________#######$##$#######_______________
_______________#......0..0......#_______________
_______________#.##.##&##&##.##.#_______________
################.##.##2##1##.##.################
________________*...________...*________________
################.##.##_##_##.##.################
_______________#.##.##_##_##.##.#_______________
_______________#.......@........#_______________
_______________##################_______________
________________________________________________
________________________________________________
________________________________________________
________________________________________________
________________________________________________
________________________________________________
________________________________________________
________________________________________________
________________________________________________
________________________________________________
________________________________________________
________________________________________________
________________________________________________
