________________________________________________
________________________________________________
________________________________________________
________________________________________________
________________________________________________
________________________________________________
________________________________________________
________________________________________________
_____________________######_____________________
_____________________#&##&#_____________________
_______________#######$##$#######_______________
_______________#......0..0......#_______________
_______________#.##.##&##&##.##.#_______________
################.##.##2__1##.##.################
________________*...___##___...*________________
################.##.##_##_##.##.################
_______________#.##.##_##_##.##.#_______________
_______________#.##.________.##.#_______________
_______________#.##.########.##.#_______________
_______________#.......@........#_______________
_______________##################_______________
________________________________________________
________________________________________________
________________________________________________
________________________________________________
________________________________________________
________________________________________________
________________________________________________
________________________________________________
________________________________________________
________________________________________________
________________________________________________